       ###################################################################                
       ##    ##########          ###########       ##########           ##                
       ##    ##########          ###########       ##########           ##################
       ##                                                               ##            G ##
       ##                                                               ##              ##
       ##                                                               ##   ##     ######
       ##         ##########     ########             ##########        ##   ##     ######
       ##         ##########     ########             ##########        ##   ##     ######
       ##         ##########              ####     #############        ##   ##     ######
       ##         ##########              ####     #######           #####   ##     ######
       ##         ##########     #############                               ##     ######
       ##                                            #######         ##########     ######
       ##                                            #######                 ##     ######
       ##                                            #######                 ##     ######
       ##         ##########         #########       #######                 ##     ######
       ##         ##########         #########       #######                 ##     ######
       ##         ##########         #########       #######                 ##     ######
       ##         ##########              ######     #######                 ##     ######
       ##                                 ######     #######                 ##     ######
       ##                               ########     #######                 #############
       ##                               ########                                ##########
       ##                               ########                                ##########
       ##                               ########                                ##        
       ##               ###    ###      ########       ###                      ##        
       ##               ###    ###      ########       ###                      ##        
       ##  #                            ########                                ##        
#########  #                                                                    ##        
##         #    #                                                               ##        
##  s           ###                                                             ##        
##                      ###    ##       ##############                          ##        
##################################################################################        
