                                      #################                                
                                      ##             ##                                
                                      ##             ##                                
                                      ##      G      ##                                
                             ###########             ##################################
                             ##                                                      ##
                             ##                                               #####  ##
      #########################                                               #####  ##
      ##                                                                      #####  ##
      ##                                                                             ##
      ##                                                                             ##
      ##         #########################         #########################         ##
      ##         #########################         #########################         ##
      #####      #########################         #########################         ##
      #####      #########################         #########################         ##
      ##         #########################         #########################         ##
      ##         #########################         #########################         ##
      ##         #########################         #########################         ##
      ##                                                                             ##
      ##                                                                             ##
      ##                                                                             ##
      ##         #########################         #########################         ##
      ##         #########################         #########################         ##
      ##         #########################         #########################         ##
      ##         #########################         #########################         ##
      ##         #########################         #########################         ##
      ##         #########################         #########################         ##
########         #########################         #########################         ##
##                                     ###                                           ##
##                                                                                   ##
##                                                                                   ##
##               #####################################################               ##
##           ######                                                 ##               ##
##      ###########                                                 ##     ######    ##
##      ######   ##                                                 ##     ############
##      ######   ##                                                 ##     ######    ##
##               ##                                                 ##               ##
##       S       ##                                                 ##               ##
##               ##                                                 ##               ##
###################                                                 ###################
